14 12
0 13
= = = = = = = = = = = = = =
= . . . . . ~ ~ . . . . . =
= . . . . . ~ ~ . . . . . =
= . . . . . ~ ~ . . . . . =
= . . . . . ~ ~ . . . . . =
= . . . . . ~ ~ . . . . . =
= . . . . . ~ ~ . . . . . =
= . . . . . ~ ~ . . . . . =
= m - - m m m - m - - - - =
= - m m - - - m - m m m m =
= ~ ~ ~ ~ ~ ~ ~ ~ ~ ~ ~ ~ =
. X X X X X X X X X X X X .
