12 10
0 11
= = = = = = = = = = = =
= . . . . ~ ~ . . . . =
= . . . . ~ ~ . . . . =
= . . . . ~ ~ . . . . =
= . . . . ~ ~ . . . . =
= . . . . ~ ~ . . . . =
= m - - m m - - - - - =
= - m m - - m m m m m =
= ~ ~ ~ ~ ~ ~ ~ ~ ~ ~ =
. X X X X X X X X X X .
